###########################
#-------------#-----------#
#-###########-#-#########-#
#-------------------------#
#-----------#####---------#
#-----##------#-----#-----#
#-----##------------#-----#
#-----##----#####---#-----#
#-----##------#-----####--#
#-----##------------------#
#-------------------------#
#-----##---###-###---#----#
#-----##---#-----#---#----#
#-----##---#######---###--#
#-----##---------------#--#
#-----###############--#--#
#-------------#--------#--#
#-###-###-----#--#######--#
#---#-###-----#-----#-----#
#----#-----#######---#----#
###-#-##------#-----#---###
###-#-##------#-----#---###
#-------------------------#
#-########--##--#########-#
#-########--##--#########-#
#-------------------------#
###########################