###########################
#-------------------------#
#-------------------------#
#-------------------------#
#-------------------------#
#-------------------------#
#-------------------------#
#-------------------------#
#-------------------------#
#-------------------------#
#-------------------------#
#-------------------------#
#-------------------------#
#-------------------------#
#-------------------------#
#-------------------------#
#-------------------------#
#-------------------------#
#-------------------------#
#-------------------------#
#-------------------------#
##-----------------------##
#-------------------------#
#-#######################-#
#-#######################-#
#-------------------------#
###########################